12 2 2 2 2 2 2 2
2 2 1 1 1 1 4 1
2 2 5 2 2 2 1 1
11 2 1 2 2 2 1 1
2 2 1 1 1 1 1 1
13 2 1 1 1 1 1 1
2 2 2 2 2 2 2 2
8 2 2 2 16 2 2 2
