12 2 2 2 3 2 2 2
2 2 1 1 1 1 4 1
2 2 5 2 2 2 1 1
11 2 1 2 2 2 1 1
2 2 1 1 1 1 1 1
13 2 1 1 1 1 1 1
2 2 6 2 7 2 9 10
8 7 2 15 16 2 14 2
